54,55,56,57,54,55,56,57,54,55,56,57,54,55,56,57,54,55,56,57,54,55,56,57,54,55,56,57,54,55,56,57,54,55,56,57,54,55,56,57,54,55,56,57,54,55,56,57,54,55,56,57,54,55,56,57,54,55,56,57,54,55,56,57,54,55,56,57,54,55,56,57,54,55,56,57,54,55,56,57,54,55,56,57,54,55,56,57,54,55,56,57,54,55,56,57,54,55,56,57,54,55,56,57,54,55,56,57,54,55,56,57,54,55,56,57,54,55,56,57,54,55,56,57,54,55,56,57,54,55,56,57,54,55,56,57,54,55,56,57,54,55,56,57,54,55,56,57,54,55
72,73,74,75,72,73,74,75,72,73,74,75,72,73,74,75,72,73,74,75,72,73,74,75,72,73,74,75,72,73,74,75,72,73,74,75,72,73,74,75,72,73,74,75,72,73,74,75,72,73,74,75,72,73,74,75,72,73,74,75,72,73,74,75,72,73,74,75,72,73,74,75,72,73,74,75,72,73,74,75,72,73,74,75,72,73,74,75,72,73,74,75,72,73,74,75,72,73,74,75,72,73,74,75,72,73,74,75,72,73,74,75,72,73,74,75,72,73,74,75,72,73,74,75,72,73,74,75,72,73,74,75,72,73,74,75,72,73,74,75,72,73,74,75,72,73,74,75,72,73
54,55,56,57,54,55,56,57,54,55,56,57,54,55,56,57,54,55,56,57,54,55,56,57,54,55,56,57,54,55,56,57,54,55,56,57,54,55,56,57,54,55,56,57,54,55,56,57,54,55,56,57,54,55,56,57,54,55,56,57,54,55,56,57,54,55,56,57,54,55,56,57,54,55,56,57,54,55,56,57,54,55,56,57,54,55,56,57,54,55,56,57,54,55,56,57,54,55,56,57,54,55,56,57,54,55,56,57,54,55,56,57,54,55,56,57,54,55,56,57,54,55,56,57,54,55,56,57,54,55,56,57,54,55,56,57,54,55,56,57,54,55,56,57,54,55,56,57,54,55
72,73,74,75,72,73,74,75,72,73,74,75,72,73,74,75,72,73,74,75,72,73,74,75,72,73,74,75,72,73,74,75,72,73,74,75,72,73,74,75,72,73,74,75,72,73,74,75,72,73,74,75,72,73,74,75,72,73,74,75,72,73,74,75,72,73,74,75,72,73,74,75,72,73,74,75,72,73,74,75,72,73,74,75,72,73,74,75,72,73,74,75,72,73,74,75,72,73,74,75,377,73,74,75,72,73,74,75,72,73,74,75,72,73,74,75,72,73,74,75,72,73,74,75,72,73,74,75,72,73,74,75,72,73,74,75,72,73,74,75,72,73,74,75,72,73,74,75,72,73
54,55,56,57,54,55,56,57,54,55,56,57,54,55,56,57,54,55,56,57,54,55,56,57,54,55,56,57,54,55,56,57,54,55,56,57,54,55,56,57,54,55,56,57,54,55,56,57,54,55,56,57,54,55,56,57,54,55,56,57,54,55,56,57,54,55,56,375,54,55,56,57,54,55,56,57,54,55,56,57,54,55,56,57,54,55,56,57,54,55,56,57,54,55,56,57,54,55,56,57,54,55,56,57,54,55,56,57,54,55,56,57,54,55,56,57,54,55,56,57,54,55,56,57,54,55,56,57,54,55,56,57,54,55,56,57,54,55,56,57,54,55,56,57,54,55,56,57,54,55
72,73,74,75,72,73,74,75,72,73,74,75,72,73,74,75,72,73,74,75,72,73,74,75,72,73,74,75,72,73,74,75,72,73,74,75,72,73,74,75,72,73,74,75,72,73,74,75,72,73,74,75,72,73,74,75,72,73,74,75,72,73,74,75,72,73,74,75,72,73,74,75,72,73,74,75,72,73,74,75,72,73,74,75,72,73,74,75,72,73,74,75,72,73,74,75,72,73,74,75,72,73,74,75,72,73,74,75,72,73,74,75,72,73,74,75,72,73,74,75,72,73,74,75,72,73,74,75,72,73,74,75,72,73,74,75,72,73,74,75,72,73,74,75,72,73,74,75,72,73
54,55,56,57,54,55,56,57,54,55,56,57,54,55,56,57,54,55,56,57,54,55,56,57,54,55,56,57,54,55,56,57,54,55,56,57,54,55,56,57,54,55,56,57,54,55,56,57,54,55,56,57,54,55,56,57,54,55,56,57,54,55,56,57,54,55,56,57,54,55,56,57,54,55,56,57,54,55,56,57,54,55,56,57,54,55,56,57,54,9,10,11,54,55,56,57,54,55,56,57,54,55,56,57,54,55,56,57,54,55,56,57,54,55,56,57,54,55,56,57,54,55,56,57,54,55,56,57,54,55,56,57,54,55,56,57,54,55,56,57,54,55,56,57,54,55,56,57,54,55
72,73,74,75,72,73,74,75,72,73,74,75,72,73,74,75,72,73,74,75,72,73,74,75,72,73,74,75,72,73,74,75,72,73,74,75,72,73,74,75,72,73,74,75,72,73,74,75,72,73,74,75,72,73,74,75,72,73,74,75,72,73,74,75,72,73,74,75,72,73,74,75,72,73,74,75,72,73,74,75,72,73,74,75,72,73,74,75,72,73,74,75,72,73,74,75,72,73,74,75,72,73,74,75,72,73,74,75,72,73,74,75,72,73,74,75,72,73,74,75,72,73,74,75,72,73,74,75,72,73,74,75,72,73,74,75,72,73,74,75,72,73,74,75,72,73,74,75,72,73
54,55,56,57,54,55,56,57,54,55,56,57,54,55,56,57,54,55,56,57,54,55,56,57,54,55,56,57,54,55,56,57,54,55,56,57,54,55,56,57,54,55,56,57,54,55,56,57,54,55,56,57,54,55,56,57,54,55,56,57,54,55,56,57,54,55,56,57,54,55,56,57,54,55,56,57,54,55,56,57,54,55,56,57,54,55,56,57,54,55,56,57,54,55,56,57,54,55,56,57,54,55,56,57,54,55,56,57,54,55,56,57,54,55,56,57,54,55,56,57,54,55,56,57,54,55,56,57,54,55,56,57,54,55,56,57,54,55,56,57,54,55,56,57,54,55,56,57,54,55
72,73,74,75,72,73,74,75,72,73,74,75,72,73,74,75,72,73,74,75,72,73,74,75,72,73,74,75,72,73,74,75,72,73,74,75,72,73,74,75,72,73,74,75,72,73,74,75,72,73,74,75,72,73,74,75,72,73,74,75,72,73,74,75,72,73,74,75,72,73,74,75,72,73,74,75,72,73,74,75,72,73,74,75,72,73,74,75,72,73,74,75,72,73,74,75,72,73,74,75,72,73,74,75,72,73,74,75,72,73,74,75,72,73,74,75,72,73,74,75,72,73,74,75,72,73,74,75,72,73,74,75,72,73,74,75,72,73,74,75,72,73,74,75,72,73,74,75,72,73
54,55,56,57,54,55,56,57,58,59,56,57,54,55,56,57,54,55,56,57,54,55,56,57,54,55,56,57,54,55,56,57,54,55,56,57,54,55,56,57,54,55,56,57,54,55,56,57,54,55,56,57,54,55,56,57,54,55,56,57,54,55,56,57,54,55,56,57,54,55,56,57,54,55,56,57,54,55,56,57,54,55,56,57,54,55,56,57,54,55,56,57,54,55,56,57,54,55,56,57,54,55,56,57,54,55,56,57,54,55,56,57,54,55,56,57,54,55,56,57,54,55,56,70,71,71,71,71,71,71,71,71,71,71,71,71,71,71,71,57,54,55,56,57,54,55,56,57,54,55
72,73,74,75,72,73,74,75,76,77,74,75,72,73,74,75,72,73,74,75,72,73,74,75,72,73,74,75,72,73,74,75,72,73,74,75,72,73,74,75,72,73,74,75,72,73,74,75,72,73,74,75,72,73,74,75,72,73,74,75,72,73,74,75,72,73,74,75,72,73,74,75,72,73,74,75,72,73,74,75,72,73,74,75,72,73,74,75,72,73,74,75,72,73,74,75,72,73,74,75,72,73,74,75,72,73,74,75,72,73,74,75,72,73,74,75,72,73,74,75,72,73,70,71,71,89,89,89,89,89,89,89,89,71,89,89,89,89,89,75,72,73,74,75,72,73,74,75,72,73
54,55,56,57,54,55,56,57,54,55,56,57,54,55,56,57,54,55,56,57,54,55,56,57,54,55,56,57,54,55,56,57,54,55,56,57,54,55,56,57,54,55,56,57,54,55,56,57,54,55,56,57,54,55,56,57,54,55,56,57,54,55,56,57,54,55,56,57,54,55,56,57,54,55,56,57,54,55,56,57,54,55,56,57,54,55,56,57,54,55,56,57,54,55,56,57,54,55,56,57,54,55,56,57,54,55,56,57,54,55,56,57,54,55,56,57,70,70,70,70,70,70,70,70,71,70,123,124,71,89,230,231,232,233,71,71,71,71,71,71,71,71,71,71,54,55,56,57,54,55
72,73,74,75,72,73,74,75,72,73,74,75,72,73,72,75,72,73,74,75,72,73,74,75,72,73,74,75,72,73,74,75,72,73,375,75,72,73,74,75,72,73,74,75,72,73,74,75,72,73,74,75,72,73,74,75,72,73,74,75,72,73,74,75,72,73,74,75,72,73,74,75,72,73,74,75,72,73,74,75,72,73,74,75,72,73,74,75,72,73,74,75,72,73,74,75,72,73,74,75,72,73,74,75,72,73,74,75,72,73,74,75,72,73,74,75,88,88,88,88,88,88,88,101,102,88,141,142,70,70,248,249,250,251,70,71,89,89,89,101,102,159,160,89,72,73,74,75,72,73
54,55,56,57,54,55,56,57,54,55,56,57,54,55,56,57,54,55,56,57,54,55,56,57,54,55,56,57,54,55,56,57,54,55,56,57,54,55,56,57,54,55,56,57,54,55,56,57,54,55,56,57,54,55,56,57,54,55,56,57,54,55,56,57,54,55,56,57,54,55,56,57,54,55,56,57,54,55,56,57,54,55,56,57,54,55,56,57,54,55,56,57,54,55,56,57,54,55,56,57,376,55,56,57,54,377,56,57,54,55,56,57,54,55,56,57,88,70,656,657,658,659,660,119,120,88,88,88,88,88,266,267,268,269,71,71,88,88,89,119,120,177,178,89,54,55,56,57,54,55
72,73,74,75,72,73,74,75,72,73,74,75,72,73,74,75,72,73,74,75,72,73,74,75,72,73,74,75,72,73,74,75,72,73,74,75,72,73,74,75,72,73,74,75,72,73,74,75,72,73,74,75,72,73,74,75,72,73,74,75,72,73,74,75,72,73,74,75,72,73,74,75,72,73,74,75,72,73,74,75,72,73,74,75,72,73,74,75,72,73,74,75,72,73,74,75,72,73,74,75,72,73,74,75,72,73,74,75,72,73,74,75,72,73,74,75,88,70,674,675,676,677,678,70,70,71,70,70,70,70,70,285,286,287,89,89,70,70,70,70,70,195,196,89,72,73,74,75,72,73
54,55,56,57,54,55,56,57,54,55,56,57,54,55,56,57,54,55,56,57,54,55,56,57,54,55,56,57,54,55,56,57,54,55,56,57,54,55,56,57,54,55,56,57,54,55,56,57,54,55,56,57,54,55,56,57,54,55,56,57,54,55,56,57,54,55,56,57,54,55,56,57,54,55,56,57,54,55,56,57,54,55,56,57,54,55,56,57,54,55,56,57,54,55,56,57,54,55,56,57,54,55,56,57,54,55,56,57,54,55,56,57,54,55,56,57,88,88,692,693,694,695,696,88,70,70,88,88,88,88,70,70,70,70,88,88,88,88,88,88,88,213,214,89,54,55,56,57,54,55
72,73,74,75,72,73,74,75,72,73,74,75,72,73,74,75,72,73,74,75,72,73,74,75,72,73,74,75,72,73,74,75,72,73,74,75,72,73,74,75,72,73,74,75,72,73,74,75,72,73,74,75,72,73,74,75,72,73,74,75,72,73,74,75,72,73,74,75,72,73,74,75,72,73,74,75,72,73,74,75,72,73,74,75,72,73,74,75,72,73,74,75,72,73,74,75,72,73,74,75,72,73,74,75,72,73,74,75,72,73,74,75,72,73,74,75,88,89,710,711,712,713,714,89,88,88,88,89,72,73,88,88,88,88,88,89,72,73,74,75,88,88,88,88,72,73,74,75,72,73
54,55,56,57,54,55,56,57,54,55,56,57,54,55,56,57,54,55,56,57,54,55,56,57,54,55,56,57,54,55,56,57,54,55,56,57,54,55,56,57,54,55,56,57,54,55,56,57,54,55,56,57,54,55,56,57,54,55,56,57,54,55,56,57,54,55,56,57,54,55,56,57,54,55,56,57,54,55,56,57,54,55,56,57,54,55,56,57,54,55,56,57,54,55,56,57,54,55,56,57,54,55,56,57,54,55,56,57,54,55,56,57,54,55,56,57,88,89,89,70,70,70,88,89,54,55,56,57,54,55,56,57,54,55,56,57,54,55,56,57,88,88,88,88,54,55,56,57,54,55
72,73,74,75,72,73,74,75,72,73,74,75,72,73,74,75,72,73,74,75,72,73,74,75,9,10,11,75,72,73,74,75,72,73,74,75,72,73,74,75,72,73,74,75,72,73,74,75,72,73,74,75,72,73,74,75,72,73,74,75,72,73,74,75,72,73,74,75,72,73,74,75,72,73,74,75,72,73,74,75,72,73,74,75,72,73,74,75,72,73,74,75,72,73,74,75,72,73,74,75,72,73,74,75,72,73,74,75,72,73,74,75,72,73,74,75,72,72,72,72,72,72,72,1389,72,73,74,75,72,73,74,75,72,73,74,75,72,73,74,75,88,88,88,88,72,73,74,75,72,73
54,55,56,57,54,55,56,57,54,55,56,57,54,55,56,57,54,55,56,57,54,55,56,57,54,55,56,57,54,55,56,57,54,55,56,57,54,55,56,57,54,55,56,57,54,55,56,57,54,55,56,57,54,55,56,57,54,55,56,57,54,55,56,57,54,55,56,57,54,55,56,57,54,55,56,57,54,55,56,57,54,55,56,57,54,55,56,57,54,55,56,57,54,55,56,57,54,55,56,57,54,55,56,57,54,55,56,57,54,55,56,57,54,55,56,57,54,55,72,72,72,55,56,57,54,55,56,57,54,55,56,57,54,55,56,57,54,55,56,57,88,88,88,88,54,55,56,57,54,55
72,73,74,75,72,73,74,75,72,73,74,75,72,73,74,75,72,73,74,75,72,73,74,75,72,73,74,75,72,73,74,75,72,73,74,75,72,73,74,75,72,73,74,75,72,73,74,75,72,73,74,75,72,73,74,75,72,73,74,75,72,73,74,75,72,73,74,75,72,73,74,75,72,73,74,75,72,73,74,75,72,73,74,75,72,73,74,75,72,73,74,75,72,73,74,75,72,73,74,75,72,73,74,75,72,73,74,75,72,73,74,75,72,73,74,75,72,73,72,75,72,73,74,75,72,73,74,75,72,73,74,75,72,73,74,75,72,73,74,75,88,88,88,88,72,73,74,75,72,73
54,55,56,57,54,55,56,57,54,55,56,57,54,55,56,57,54,55,56,57,54,55,56,57,54,55,56,57,54,55,56,57,54,55,56,57,54,55,56,57,54,55,56,57,54,55,56,57,54,55,56,57,54,55,56,57,54,55,56,57,54,55,56,57,54,55,56,57,54,55,56,57,54,55,56,57,54,55,56,57,54,55,56,57,54,55,56,57,54,55,56,57,54,55,56,57,54,55,56,57,54,55,56,57,54,55,56,57,54,55,56,57,54,55,56,57,54,55,56,57,54,55,56,57,54,55,56,57,54,55,56,57,54,55,56,57,54,55,56,57,88,88,88,88,54,55,56,57,54,55
72,73,74,75,72,73,74,75,72,73,74,75,72,73,74,75,72,73,74,75,72,73,74,75,72,73,74,75,72,73,74,75,72,73,74,75,72,73,74,75,72,73,74,75,72,73,74,75,72,73,74,75,72,73,74,75,72,73,74,75,72,73,74,75,72,73,74,75,72,73,74,75,72,73,74,75,72,73,74,75,72,73,74,75,72,73,74,75,72,73,74,75,72,73,74,75,72,73,74,75,72,73,74,75,72,73,74,75,72,73,74,75,72,73,74,75,72,73,74,75,72,73,74,1389,72,73,74,75,72,73,74,75,72,73,74,75,72,73,74,75,88,88,88,88,88,73,74,75,72,73
54,55,56,57,54,55,56,57,54,55,56,57,54,55,56,57,54,55,56,57,60,61,56,57,54,55,56,57,374,55,56,57,54,55,56,57,54,55,56,57,54,55,56,57,54,55,56,57,54,55,56,57,54,55,56,57,54,55,56,57,54,55,56,57,54,55,56,57,54,55,56,57,54,55,56,57,54,55,56,57,54,55,56,57,54,55,56,57,54,55,56,57,54,55,56,57,54,55,56,57,54,55,56,57,54,55,56,57,54,55,56,57,54,55,56,57,54,55,56,57,54,55,56,57,54,55,56,57,54,55,56,57,54,55,56,57,54,55,88,88,88,88,88,88,54,55,56,57,54,55
72,73,74,75,72,73,74,75,72,73,74,75,72,73,74,75,72,73,74,75,78,79,74,75,72,73,74,75,72,73,74,75,72,73,74,75,72,73,74,75,72,73,74,75,72,73,74,75,72,73,74,75,72,73,74,75,72,73,74,75,72,73,74,75,72,73,74,75,72,73,74,75,72,73,74,75,72,73,74,75,72,73,74,75,72,73,74,75,72,73,74,75,72,73,74,75,72,73,74,75,72,73,74,75,72,73,74,75,72,73,74,75,72,73,74,75,72,73,74,75,72,73,74,75,72,73,74,75,72,73,74,75,72,73,74,75,72,73,74,75,72,73,74,75,72,73,74,75,72,73
54,55,56,57,54,55,56,57,54,55,56,374,54,55,56,57,54,55,56,57,54,55,56,57,54,55,56,57,54,55,56,57,54,55,56,57,54,55,56,57,54,55,56,57,54,55,56,57,54,55,56,57,54,55,56,57,54,55,56,57,54,55,56,57,54,55,56,57,54,55,56,57,54,55,56,57,54,55,56,57,54,55,56,57,54,55,56,57,54,55,56,57,54,55,56,57,54,55,56,57,54,55,56,57,54,376,56,57,54,55,56,57,54,55,56,57,54,55,56,57,54,55,56,57,54,55,324,325,326,327,328,329,330,331,332,333,54,55,56,57,54,55,56,57,54,55,56,57,54,55
72,73,74,75,72,73,74,75,72,73,74,75,72,73,74,75,72,73,74,75,72,73,74,75,72,73,74,75,72,73,74,75,72,73,74,75,72,73,74,75,72,73,74,75,72,73,74,75,72,73,74,75,72,73,74,75,72,73,74,75,72,73,74,75,72,73,74,75,72,73,74,75,72,73,74,75,72,73,74,75,72,73,74,75,72,73,74,75,72,73,74,75,72,73,74,75,72,73,74,75,72,73,74,75,72,73,74,75,72,73,74,75,72,73,74,75,72,73,74,75,72,73,74,75,72,73,342,343,344,345,346,347,348,349,350,351,72,73,74,75,72,73,74,75,72,73,74,75,72,73
54,55,56,57,54,55,56,57,54,55,56,57,54,55,56,57,54,55,56,57,54,55,56,57,54,55,56,57,54,55,56,57,54,55,56,57,54,55,56,57,54,55,56,57,54,55,56,57,54,55,56,57,54,55,56,57,54,55,56,57,54,55,56,57,54,55,56,57,54,55,56,57,54,55,56,57,54,55,56,57,54,55,56,57,54,55,56,57,54,55,56,57,54,55,56,57,54,55,56,57,54,55,56,57,54,55,56,57,54,55,56,57,54,55,56,57,54,55,56,57,54,55,56,57,54,55,56,57,54,55,56,57,54,55,56,57,54,55,56,57,54,55,56,57,54,55,56,57,54,55
72,73,74,75,72,73,74,75,72,73,74,75,72,73,74,75,72,73,74,75,72,73,74,75,72,73,74,75,72,73,74,75,72,73,74,75,72,73,74,75,72,73,74,75,72,73,74,75,72,73,74,75,72,73,74,75,72,73,74,75,72,73,74,75,72,73,74,75,72,73,74,75,72,73,74,75,72,73,74,75,72,73,74,75,72,73,74,75,72,73,74,75,72,73,74,75,72,73,74,75,72,73,74,75,72,73,74,75,72,73,74,75,72,73,74,75,72,73,74,75,72,73,74,75,72,73,74,75,72,73,74,75,72,73,74,75,72,73,74,75,72,73,74,75,72,73,74,75,72,73
54,55,56,57,54,55,56,57,54,55,56,57,54,55,56,57,54,55,56,57,54,55,56,57,54,55,56,57,54,55,56,57,54,55,56,57,54,55,56,57,54,55,56,57,54,55,56,57,54,55,56,57,54,55,56,57,54,55,56,57,54,55,56,57,54,55,56,57,54,55,56,57,54,55,56,57,54,55,56,57,54,55,56,57,54,55,56,57,54,55,56,57,54,55,56,57,54,55,56,57,54,55,56,57,54,55,56,57,54,55,56,57,54,55,56,57,54,55,56,57,54,55,56,57,54,55,56,57,54,55,56,57,54,55,56,57,54,55,56,57,54,55,56,57,54,55,56,57,54,55
72,73,74,75,72,73,74,75,72,73,74,75,72,73,74,75,72,73,74,75,72,73,74,75,72,73,74,75,72,73,74,75,72,73,74,75,72,73,74,75,72,73,74,75,72,73,74,75,72,73,74,75,72,73,74,75,72,73,74,75,72,73,74,75,72,73,74,75,72,73,74,75,72,73,74,75,72,73,74,75,72,73,74,75,72,73,74,75,72,73,74,75,72,73,74,75,72,73,74,75,72,73,74,75,72,73,74,75,72,73,74,75,72,73,74,75,72,73,74,75,72,73,74,75,72,73,74,75,72,73,74,75,72,73,74,75,72,73,74,75,72,73,74,75,72,73,74,75,72,73
